05,0,0,0,0,0,0,0,0,0,0,0,4,9,0,0,4,2,0,0,0,2,0,0,0,0,0,0,0,0,0,0,0,3,0,0,0
05,0,0,3,0,0,0,0,0,2,0,2,0,9,0,0,2,0,0,0,0,0,0,0,0,0,0,1,0,0,0,0,0,0,0,0,0
05,2,1,0,0,0,4,0,0,0,0,0,0,9,0,2,0,4,0,0,0,0,0,0,0,0,3,0,0,0,0,0,0,0,0,0,0
06,0,0,0,0,0,2,1,0,2,0,0,0,9,0,0,0,0,4,1,0,2,0,0,0,0,0,0,0,0,0,0,0,1,0,1,0
05,0,2,1,0,2,0,0,0,2,2,0,0,9,0,0,0,0,0,1,0,2,0,0,0,0,0,0,0,0,0,0,0,0,1,0,0
07,1,0,0,1,0,0,0,0,0,2,0,2,9,0,0,0,0,0,0,0,4,3,0,0,1,0,0,0,0,0,0,0,0,0,0,0
07,0,0,0,1,0,0,0,0,0,2,2,4,0,9,0,0,0,0,0,0,4,0,0,0,0,0,0,0,0,0,0,0,0,3,0,0
07,0,0,0,0,0,0,3,0,0,0,4,0,9,0,0,0,0,2,0,0,2,2,0,0,0,0,0,0,1,0,3,0,0,0,0,0
08,0,0,1,0,4,0,0,0,0,0,0,2,9,0,2,0,0,0,0,0,0,1,0,0,2,0,0,3,0,0,0,0,0,1,0,0
07,0,3,0,0,0,0,0,0,2,1,0,4,9,0,0,4,2,0,0,0,0,0,0,0,0,2,0,0,0,0,0,0,3,0,0,0
09,1,0,0,0,2,0,0,0,4,0,0,0,9,0,0,0,0,4,0,0,0,0,0,0,0,0,3,0,0,0,0,0,0,1,0,0
07,0,0,3,0,0,0,0,0,0,4,1,0,2,9,0,0,0,0,0,2,0,0,2,0,0,0,1,0,0,0,0,0,0,0,0,0
07,1,0,0,1,0,0,0,0,0,2,0,2,0,9,0,0,0,0,0,0,4,3,0,0,1,0,0,0,0,0,1,0,0,0,0,0
06,0,2,2,0,1,0,2,0,0,0,0,0,0,0,9,0,2,0,0,0,0,4,0,0,1,0,0,0,1,0,0,1,0,0,0,0
07,0,0,0,0,1,0,0,0,0,1,0,4,3,0,0,9,0,0,0,1,0,0,0,0,0,2,0,3,0,0,0,0,1,0,1,0
06,0,0,0,0,4,0,3,0,0,0,0,0,0,0,9,0,0,0,0,4,0,2,1,0,0,0,0,0,0,0,0,0,0,3,0,0
09,0,1,0,0,4,0,2,0,1,0,0,0,0,9,0,0,0,0,0,0,4,0,1,0,0,0,0,0,0,0,0,0,0,0,0,0
07,0,0,0,0,0,0,0,1,0,0,4,0,9,0,2,0,0,0,1,0,0,0,0,0,0,2,0,0,0,0,0,0,3,0,0,0
08,0,0,0,0,0,2,0,0,4,2,0,0,9,0,0,0,0,4,0,0,0,0,0,0,0,0,1,0,0,0,0,0,0,3,0,0
07,0,1,0,4,0,0,0,1,0,0,0,2,0,9,0,0,0,0,1,0,0,0,0,2,2,0,3,0,0,0,0,0,0,3,0,0
09,0,0,2,4,2,0,1,0,0,0,0,0,9,0,0,0,0,0,4,3,0,0,0,0,0,0,0,0,0,0,0,0,1,0,0,0
08,0,0,0,0,0,4,2,3,0,0,2,0,0,0,9,0,0,0,0,4,0,2,1,0,2,0,0,0,0,0,0,0,3,0,0,0
09,1,0,1,0,4,2,1,0,0,2,0,0,0,9,0,0,0,0,0,4,1,0,0,0,0,0,0,0,0,0,0,0,3,0,0,0
11,1,0,1,0,2,0,0,1,0,2,0,0,9,0,0,0,0,4,0,0,0,1,0,0,0,2,2,1,0,0,0,0,0,3,0,0
09,0,0,0,4,0,0,0,0,0,0,0,0,0,9,0,0,0,2,2,3,0,0,0,0,0,0,2,0,1,0,0,0,0,3,0,0
10,0,0,0,0,0,0,2,1,0,0,0,4,0,9,0,4,0,0,3,0,0,0,0,0,0,0,2,0,0,0,0,0,0,1,0,0
10,0,0,0,0,4,0,0,0,0,4,0,0,0,9,0,0,0,0,1,0,2,0,0,0,2,0,0,3,0,0,0,0,3,0,0,0
08,0,0,0,4,0,4,3,0,0,0,2,0,9,0,2,0,0,0,4,0,0,0,0,0,0,0,0,0,0,0,0,0,0,3,0,0
10,0,0,0,0,4,4,0,2,1,0,0,0,0,0,9,0,0,0,0,0,4,2,1,0,0,0,0,0,0,0,0,0,0,0,0,0
08,0,0,0,2,1,0,0,0,0,0,0,2,0,9,0,4,4,0,0,0,0,0,0,4,0,0,0,0,0,0,0,3,0,0,0,0
09,0,0,1,0,0,0,0,0,0,0,0,0,9,0,2,4,0,0,1,0,0,0,0,2,0,2,0,0,0,0,0,0,3,0,0,0
08,2,2,0,3,0,0,0,0,4,0,1,0,9,0,0,0,0,0,0,0,0,0,2,4,0,0,0,0,0,0,3,0,0,0,0,0
08,4,0,0,4,0,0,0,0,0,0,0,0,0,9,0,0,0,0,1,0,2,0,0,0,0,2,0,0,0,0,0,0,3,0,0,0
09,2,2,0,0,4,0,0,0,0,0,0,2,0,0,9,0,0,0,0,1,0,2,0,0,0,0,2,0,1,0,0,0,0,3,0,0
10,0,1,0,3,0,0,2,0,0,0,0,4,0,0,0,9,0,0,3,0,0,0,0,0,0,0,2,0,1,0,0,0,0,3,0,0
08,0,0,0,0,4,4,0,1,0,0,0,0,0,4,9,0,0,0,0,0,2,0,0,0,0,0,0,0,1,0,0,0,0,0,0,0
08,2,0,1,0,0,0,0,0,0,0,4,0,0,9,0,2,0,0,0,0,4,0,0,0,0,0,0,1,0,0,0,0,0,0,0,0
09,0,0,0,1,0,4,4,0,0,2,4,0,0,9,0,0,0,0,0,0,0,0,0,0,0,0,2,1,0,0,0,0,0,0,1,0
08,0,0,0,0,4,0,0,1,0,2,0,0,9,0,0,0,0,2,0,0,2,1,0,0,0,0,0,0,0,0,0,0,0,3,0,0
07,0,3,0,0,0,0,0,0,0,0,0,2,0,9,0,0,4,0,0,0,0,4,0,0,0,0,2,0,0,0,0,0,0,0,1,0
09,0,0,0,1,0,0,2,0,3,0,0,4,0,9,0,2,4,0,0,0,0,0,0,0,0,2,1,0,0,0,0,0,0,3,0,0
08,0,0,0,1,0,0,1,0,0,2,0,0,0,9,0,0,4,2,0,4,1,0,0,0,0,0,0,0,0,0,0,0,3,0,0,0
10,0,0,0,1,0,4,0,0,4,2,0,0,9,0,0,0,0,0,0,0,0,0,1,0,0,0,3,0,0,0,0,0,0,0,0,0
09,0,0,3,0,0,2,0,0,2,4,0,0,9,0,0,0,0,0,4,1,0,0,0,0,0,0,3,0,0,0,0,0,1,0,0,0
09,0,0,0,0,0,4,0,0,0,1,0,0,0,0,9,0,2,0,0,0,4,0,0,0,0,0,0,2,1,0,0,0,0,0,0,0
08,0,2,1,0,0,0,0,0,0,0,0,4,0,0,9,0,0,0,0,0,2,4,0,0,0,0,0,0,1,0,1,0,0,0,0,0
10,4,0,3,0,0,4,0,2,0,0,2,0,0,0,9,0,0,0,0,0,0,4,1,0,0,0,0,0,0,0,0,0,0,0,0,0
08,0,0,0,4,0,0,0,1,0,0,2,0,9,0,0,0,0,4,4,0,3,0,0,0,0,0,3,0,0,0,0,0,0,0,0,0
08,0,2,0,3,0,0,0,0,0,0,0,0,9,0,4,0,0,0,1,0,0,0,0,4,0,0,0,0,0,0,0,3,0,0,0,0
09,0,0,1,0,2,0,3,0,0,4,0,0,9,0,0,0,0,0,0,1,0,0,0,0,2,0,2,1,0,0,0,0,0,3,0,0
10,3,0,0,0,0,0,0,0,2,4,0,2,9,0,0,0,2,0,4,0,0,0,0,0,0,0,3,0,0,0,0,0,0,1,0,0
09,0,0,1,0,0,0,0,0,4,0,0,2,9,0,0,0,0,0,2,0,0,0,0,2,0,0,3,0,0,0,1,0,0,0,0,0
08,0,0,0,0,0,4,2,0,3,0,0,0,0,0,0,9,0,0,0,0,0,4,1,0,0,0,0,0,0,0,0,1,0,0,0,0
09,0,0,1,0,0,0,0,0,4,0,0,0,9,0,0,0,0,0,2,0,0,3,0,0,0,1,0,0,2,0,3,0,0,0,0,0
08,0,0,2,1,0,0,4,0,0,4,2,0,0,9,0,0,0,0,0,0,0,0,1,0,0,0,0,1,0,2,0,0,3,0,0,0
08,0,0,2,0,4,0,1,0,0,0,0,0,4,9,0,0,0,2,0,1,0,0,0,0,0,0,2,0,0,0,0,0,0,0,1,0
09,1,0,2,0,0,0,0,0,0,0,1,0,9,0,2,0,0,0,0,0,0,0,0,4,0,3,0,0,0,0,0,0,0,0,0,0
09,2,0,1,0,0,0,0,1,0,4,0,0,0,9,0,0,2,0,1,0,0,0,0,0,0,2,1,0,0,0,0,0,0,3,0,0
09,0,0,0,0,0,0,2,1,0,0,0,0,0,0,9,0,4,4,2,0,4,0,0,0,0,0,0,2,0,0,0,0,0,0,1,0
11,0,0,0,0,0,0,2,0,0,2,2,4,0,9,0,0,0,0,0,2,3,0,0,0,0,0,0,2,1,0,3,0,0,0,0,0
09,0,0,0,0,0,0,0,0,1,0,4,0,9,0,0,2,0,2,0,0,2,0,0,0,0,0,0,2,1,0,0,0,0,0,0,0
12,0,0,2,1,0,0,0,0,0,4,0,2,0,9,0,0,0,0,0,2,0,0,1,0,0,0,1,0,2,0,0,0,0,0,0,0
08,0,0,2,0,4,0,1,0,0,0,0,0,4,9,0,0,0,4,0,0,1,0,0,0,0,0,2,0,0,0,0,0,0,1,0,0
12,0,0,0,1,0,0,3,0,0,2,0,4,0,9,0,0,0,0,0,0,2,1,0,0,0,0,0,2,1,0,0,0,0,0,0,0
10,2,1,0,0,4,0,0,2,0,0,0,2,0,0,9,0,0,0,0,0,2,1,0,0,0,0,0,0,1,0,3,0,0,0,0,0
12,0,1,0,0,0,0,0,3,0,0,0,4,4,4,0,9,0,0,0,0,1,0,0,0,0,0,0,2,1,0,3,0,0,0,0,0
13,0,1,0,0,0,0,1,0,2,0,0,0,4,4,0,9,0,4,0,0,3,0,0,0,0,0,2,2,0,0,1,0,0,0,1,0
12,2,1,0,3,0,0,0,0,2,0,0,0,9,0,0,4,0,0,2,0,0,0,0,0,0,1,0,0,0,2,0,0,0,1,0,0
09,0,0,2,4,1,0,1,0,0,0,0,2,0,9,0,0,2,0,0,4,0,0,0,0,0,0,1,0,0,0,0,0,1,0,0,0
13,0,0,2,1,0,0,0,0,0,0,4,2,0,4,9,0,0,0,0,0,1,0,0,0,0,0,0,2,1,0,0,0,0,0,0,0
10,0,1,0,2,0,0,4,0,0,0,1,0,0,0,0,9,0,2,0,1,0,2,0,0,2,1,0,0,1,0,0,3,0,0,0,0
13,1,0,0,0,0,0,2,3,0,0,0,0,0,9,0,4,0,0,2,1,0,0,0,0,0,2,0,0,0,2,0,0,3,0,0,0
09,0,0,1,0,0,0,0,0,1,0,4,4,2,9,0,0,0,0,0,0,1,0,0,0,0,0,0,2,1,0,0,0,0,0,1,0
11,0,3,0,0,2,0,2,1,0,0,0,4,0,0,4,9,0,0,1,0,0,1,0,0,0,0,0,2,1,0,0,1,0,0,0,0
12,0,0,0,4,0,0,2,0,0,0,4,0,0,9,0,0,0,0,0,2,1,0,0,0,0,0,0,0,0,2,0,0,3,0,0,0
12,0,0,0,1,0,0,2,0,0,0,0,0,0,0,9,0,4,0,3,0,0,2,0,0,0,0,2,0,0,0,0,0,0,3,0,0
12,0,4,0,0,4,0,0,0,0,0,0,0,0,0,9,0,0,0,0,0,0,2,0,0,0,0,0,0,1,0,1,0,0,1,0,0
13,2,0,0,2,0,0,0,1,0,0,4,0,2,0,9,0,0,0,0,1,0,2,0,0,1,0,2,0,0,2,0,0,0,1,0,0
13,2,3,0,0,1,0,0,0,0,4,2,0,0,9,0,0,0,0,2,0,0,0,1,0,0,3,0,0,0,0,1,0,0,1,0,0
14,0,4,0,0,1,0,0,0,0,0,4,0,0,0,9,0,0,0,1,0,2,0,0,0,2,0,0,1,0,2,0,1,0,0,0,0
13,3,0,0,0,2,0,0,2,1,0,0,0,0,0,4,9,0,4,0,0,0,1,0,0,2,0,0,2,0,0,0,1,0,0,1,0
12,0,0,0,0,0,0,0,0,4,1,0,0,9,0,0,2,0,0,2,0,0,0,1,0,0,3,0,0,0,2,0,0,3,0,0,0
13,0,0,2,2,1,0,0,0,0,0,4,0,0,0,9,0,0,0,1,0,2,0,0,0,0,2,0,1,0,2,0,0,3,0,0,0
12,0,0,2,0,1,0,0,0,0,0,2,0,0,9,0,0,0,4,0,0,4,1,0,0,0,0,0,2,0,0,0,0,0,0,1,0
13,1,0,1,0,0,0,2,0,0,2,1,0,0,9,0,0,4,0,1,0,2,0,0,0,0,2,0,0,0,2,0,0,3,0,0,0
12,0,2,0,1,0,4,0,0,3,0,0,0,0,9,0,4,0,0,0,0,2,0,1,0,0,0,0,0,0,0,0,0,0,0,0,0
13,0,0,0,2,0,0,0,0,0,0,1,0,0,0,9,0,4,0,2,3,0,0,0,0,0,0,2,0,0,2,0,0,0,1,0,0
13,0,0,1,0,0,0,2,0,0,2,1,0,0,9,0,0,2,0,0,2,1,0,0,0,0,0,2,2,1,0,1,0,0,0,0,0
11,0,0,0,2,1,0,0,2,0,0,2,4,0,0,9,0,0,0,0,0,4,1,0,0,0,0,0,2,1,0,0,0,0,0,0,0
11,2,0,0,0,0,0,0,1,0,0,2,0,0,0,9,0,0,4,0,0,3,0,0,0,0,0,2,0,0,0,0,0,0,3,0,0
12,0,0,0,2,1,0,0,0,0,0,0,4,0,0,0,9,0,0,0,1,0,2,0,0,0,2,0,0,1,0,0,0,1,0,0,0
13,0,0,0,0,1,0,0,1,0,0,2,0,2,2,9,0,0,4,0,0,4,1,0,0,1,0,0,2,0,0,0,0,0,0,1,0
09,0,2,0,1,0,0,0,0,1,0,2,4,9,0,2,0,0,0,2,4,0,2,0,0,0,0,0,0,1,0,0,0,1,0,0,0
12,0,1,0,3,0,0,0,0,0,0,2,0,2,0,9,0,0,0,0,0,3,0,0,0,0,0,2,2,1,0,1,0,0,0,0,0
10,0,0,1,0,0,0,0,0,1,0,1,0,0,9,0,2,4,0,0,0,4,0,0,2,0,0,0,2,0,0,0,0,0,0,1,0
13,0,0,0,0,0,0,0,1,0,1,0,4,0,0,9,0,2,0,0,0,4,2,0,0,0,0,0,0,1,0,0,0,0,3,0,0
13,0,0,0,2,0,0,0,0,4,0,0,0,9,0,0,0,0,0,0,2,0,1,0,4,0,0,1,0,2,0,3,0,0,0,0,0
12,0,0,0,2,1,0,0,0,0,0,0,4,0,0,0,9,0,0,1,0,0,2,0,0,0,2,0,0,1,0,0,0,1,0,0,0
11,4,0,3,0,0,0,0,0,0,0,4,0,0,0,9,0,0,0,0,3,0,0,0,0,0,1,0,2,1,0,0,1,0,0,0,0
13,0,2,1,0,1,0,0,0,0,4,2,0,0,9,0,0,0,0,0,0,2,0,1,0,2,0,0,1,0,2,0,1,0,0,0,0
14,1,0,0,2,1,0,0,0,0,0,4,4,0,0,9,0,0,0,0,4,1,0,0,0,0,0,2,0,0,0,0,0,0,0,1,0
15,0,0,3,0,0,0,0,0,4,1,0,2,9,0,0,0,0,0,1,0,0,2,1,0,2,0,0,0,2,0,0,3,0,0,0,0
14,0,0,0,0,0,2,0,0,3,0,0,0,0,9,0,4,0,0,1,0,2,0,1,0,2,0,0,0,2,0,0,3,0,0,0,0
14,0,0,0,2,0,0,0,0,4,0,1,0,9,0,0,0,0,2,2,0,0,1,0,0,0,3,0,0,2,0,3,0,0,0,0,0
14,2,0,0,2,1,0,0,0,4,0,0,4,9,0,0,0,0,0,0,0,0,1,0,0,0,3,0,0,2,0,0,0,0,0,0,0
14,1,0,2,0,0,0,0,2,0,1,0,0,0,0,9,0,2,4,1,0,4,4,0,0,1,0,0,0,0,0,0,0,0,0,1,0
13,0,0,2,1,0,0,1,0,0,0,2,0,0,2,9,0,0,4,0,0,4,1,0,0,0,0,0,2,0,0,0,0,0,0,1,0
14,0,2,0,0,1,0,0,0,3,0,0,2,0,9,0,2,0,0,1,0,2,0,1,0,2,0,0,3,0,0,0,1,0,0,0,0
16,0,3,0,0,0,0,0,0,4,2,1,0,9,0,0,0,0,2,2,0,0,1,0,0,0,1,0,2,0,0,0,0,0,0,0,0
14,0,0,3,0,0,0,0,0,2,0,0,0,9,0,0,4,0,0,2,1,0,0,0,0,0,0,2,0,1,0,0,0,0,3,0,0
14,2,3,0,0,0,0,0,0,4,2,1,0,9,0,0,0,4,2,0,0,0,4,0,0,0,0,0,0,0,0,0,0,0,0,1,0
11,2,0,1,0,0,2,0,0,2,1,0,0,9,0,0,0,2,0,0,2,1,0,0,0,0,0,0,2,1,0,3,0,0,0,0,0
14,2,1,0,1,0,0,0,2,0,0,2,0,0,0,9,0,0,4,1,0,4,1,0,0,0,0,0,2,0,0,0,0,0,0,1,0
16,0,0,1,0,1,0,2,0,0,2,4,0,0,9,0,0,0,4,0,4,1,0,0,0,0,0,2,1,0,0,0,0,0,0,1,0
17,0,0,0,0,1,0,3,0,0,1,0,4,2,0,9,0,2,0,0,1,0,2,0,0,0,0,2,0,1,0,0,0,0,3,0,0
15,1,0,0,0,1,0,0,0,2,0,0,4,0,4,0,9,0,0,0,0,1,0,0,0,0,0,0,2,1,0,3,0,0,0,0,0
16,0,0,2,1,0,2,0,0,0,0,2,0,1,0,9,0,0,0,2,4,2,1,0,4,0,0,0,0,0,0,0,0,3,0,0,0
17,0,0,1,0,2,0,1,0,2,0,0,0,0,4,0,9,0,4,0,0,1,0,0,0,0,0,2,2,0,0,1,0,0,0,1,0
16,0,3,0,0,4,2,0,1,0,0,0,0,2,0,9,0,0,0,0,1,0,1,0,2,0,0,2,0,0,0,0,0,0,3,0,0
16,0,3,0,0,0,0,0,4,3,0,0,4,4,0,9,0,2,0,0,0,1,0,0,0,0,0,2,2,1,0,1,0,0,0,0,0
16,2,2,1,0,4,0,0,0,2,0,0,0,9,0,0,0,0,2,0,0,2,1,0,0,0,0,0,2,1,0,3,0,0,0,0,0
16,2,0,0,1,0,0,0,3,0,0,4,2,2,0,9,0,0,0,0,1,0,0,0,2,0,0,2,1,0,0,0,0,0,0,1,0
17,0,4,1,0,0,4,2,0,3,0,0,0,0,0,9,0,2,0,2,1,0,0,0,0,0,0,0,2,1,0,0,1,0,0,0,0
16,0,1,0,3,0,0,1,0,1,0,4,0,2,9,0,2,0,0,0,1,0,0,0,0,0,0,2,3,0,0,0,0,0,1,0,0
19,0,0,2,1,0,2,0,2,0,0,2,0,0,0,9,0,0,0,1,0,2,4,1,0,2,0,0,0,0,0,0,1,0,0,0,0
15,4,1,0,1,0,0,0,0,0,4,0,2,0,9,0,0,0,0,1,0,0,0,1,0,0,2,1,0,2,0,0,0,1,0,0,0
16,3,0,0,0,0,0,0,0,0,2,1,0,0,9,0,0,0,2,0,2,3,0,0,0,0,0,0,2,1,0,1,0,0,0,0,0
17,0,0,1,0,0,0,1,0,2,0,1,0,0,2,0,9,0,4,0,0,3,0,0,0,2,1,0,2,0,0,0,0,0,0,1,0
17,2,0,0,0,1,0,0,3,0,0,0,4,2,0,0,9,0,0,0,1,0,2,0,0,0,0,2,0,1,0,1,0,0,1,0,0
20,0,0,0,2,1,0,0,1,0,0,4,0,4,0,9,0,0,0,0,1,0,0,0,2,0,0,2,1,0,0,1,0,0,0,1,0
16,0,0,2,3,0,0,0,0,0,1,0,4,0,0,9,0,2,0,1,0,2,2,0,0,0,2,0,0,1,0,0,0,1,0,0,0
16,0,0,0,0,4,0,4,0,0,0,0,0,0,4,9,0,0,2,0,0,2,1,0,0,0,0,0,2,1,0,3,0,0,0,0,0
17,0,2,3,0,0,0,2,0,1,0,4,2,0,9,0,2,0,0,2,1,0,0,0,0,0,0,2,3,0,0,0,0,0,0,0,0
16,0,0,0,1,0,0,0,0,0,1,0,0,0,0,9,0,4,0,2,3,0,0,0,0,0,0,2,2,0,0,1,0,0,0,1,0
19,0,0,1,0,1,0,0,0,0,0,2,4,0,0,9,0,0,0,2,0,4,1,0,0,0,0,0,2,1,0,0,0,0,0,0,0
15,2,0,0,0,1,0,0,3,0,0,4,0,9,0,2,0,0,0,1,0,0,4,0,0,0,0,0,0,1,0,0,0,0,0,0,0
19,1,0,0,1,0,4,4,2,0,0,4,0,0,0,9,0,0,0,0,1,0,2,0,0,0,0,2,0,1,0,0,0,0,1,0,0
17,1,0,3,0,0,0,2,2,0,0,4,2,0,0,9,0,0,0,1,0,2,0,0,0,0,0,0,3,0,0,3,0,0,0,0,0
15,0,1,0,0,0,0,2,0,0,0,0,0,0,1,0,9,0,4,2,3,0,0,2,0,0,0,2,2,0,0,1,0,0,0,1,0
18,3,0,0,2,0,0,4,0,0,0,1,0,0,0,0,9,0,2,0,1,0,2,0,0,2,1,0,0,1,0,0,3,0,0,0,0
16,1,0,0,3,0,0,0,2,3,0,0,2,0,0,9,0,2,0,1,0,2,0,0,0,2,0,0,3,0,0,0,3,0,0,0,0
18,0,4,0,1,0,0,0,0,0,0,4,2,0,0,9,0,0,0,2,1,0,0,0,2,0,0,2,1,0,0,1,0,0,0,1,0
15,0,1,0,0,1,0,0,0,2,1,0,2,9,0,0,4,0,0,1,0,0,0,1,0,0,2,0,0,2,0,0,0,1,0,0,0
20,0,2,0,0,1,0,0,0,1,0,2,0,9,0,2,0,0,4,1,0,0,1,0,0,2,1,0,2,0,0,0,0,0,0,1,0
16,0,0,2,3,0,0,2,0,0,1,0,2,0,9,0,2,0,0,1,0,0,0,1,0,0,2,1,0,2,0,0,0,0,0,0,0
18,0,0,1,0,0,0,0,0,2,4,2,0,9,0,0,0,0,0,1,0,2,0,1,0,2,0,0,1,0,2,0,3,0,0,0,0
16,0,1,0,1,0,4,0,0,2,2,0,0,9,0,0,0,0,0,1,0,2,2,1,0,2,0,0,0,0,0,0,3,0,0,0,0
18,1,0,2,1,0,0,2,2,0,0,2,4,0,0,9,0,0,0,0,0,0,4,0,0,0,0,0,0,1,0,0,0,0,0,0,0
17,2,0,2,0,0,0,0,0,0,3,0,0,2,9,0,2,0,4,0,4,0,0,0,0,0,0,3,0,0,0,0,0,0,3,0,0
17,0,4,0,1,0,4,0,0,1,0,4,0,0,0,9,0,0,0,2,1,0,2,0,0,0,0,2,0,1,0,0,0,0,1,0,0
15,2,3,0,0,0,0,0,0,0,2,1,0,4,9,0,0,0,2,0,0,2,1,0,0,0,0,0,2,1,0,0,1,0,0,0,0
17,0,0,0,2,1,0,4,0,0,0,4,0,0,0,9,0,0,0,0,1,0,2,0,0,0,0,2,0,1,0,0,0,0,1,0,0
18,0,1,0,2,1,0,4,2,0,0,4,0,0,0,9,0,0,0,0,1,0,0,0,2,0,0,2,1,0,0,0,0,0,3,0,0
17,4,0,3,0,0,0,0,1,0,0,2,4,0,4,9,0,0,0,0,0,4,1,0,0,0,0,0,2,1,0,1,0,0,0,0,0
15,2,2,1,0,0,2,0,0,3,0,0,0,9,0,2,0,4,0,0,4,0,0,0,2,0,0,1,0,0,0,0,0,0,3,0,0
19,0,2,0,0,1,0,2,0,1,0,4,0,0,9,0,2,0,0,3,0,0,0,0,2,0,0,2,1,0,0,0,0,0,0,1,0
19,0,0,2,0,0,2,0,2,0,1,0,0,0,0,9,0,2,0,1,0,2,4,0,0,2,0,0,0,1,0,0,1,0,0,0,0
17,1,0,2,1,0,0,2,0,0,3,0,0,0,9,0,2,0,4,0,4,0,0,0,0,0,0,3,0,0,0,0,0,1,0,1,0
15,0,0,2,0,1,0,1,0,0,1,0,4,2,0,9,0,2,0,0,3,0,0,0,0,1,0,0,2,1,0,0,0,0,0,0,0
18,2,1,0,0,1,0,0,0,2,1,0,2,9,0,0,4,0,0,0,4,0,0,1,0,0,0,0,0,2,0,0,0,1,0,0,0
17,0,2,0,0,4,0,0,0,1,0,0,0,0,9,0,2,0,0,0,2,0,0,1,0,0,0,2,1,0,0,1,0,0,0,0,0
15,0,0,0,4,1,0,0,0,0,0,4,0,4,9,0,0,0,0,0,0,1,0,0,0,0,0,2,1,0,2,0,0,0,1,0,0
19,0,0,2,3,0,0,0,0,0,0,2,0,0,2,9,0,0,4,0,0,3,0,0,0,0,2,3,0,0,0,0,0,0,0,1,0
18,1,0,1,0,2,0,0,4,2,0,0,0,0,0,0,9,0,4,0,0,3,0,0,0,2,1,0,2,0,0,0,0,0,0,1,0
17,0,0,0,0,1,0,1,0,2,0,0,4,0,2,0,9,0,0,2,0,3,0,0,0,0,1,0,2,1,0,1,0,0,0,0,0
17,0,0,0,0,0,0,0,1,0,0,4,0,4,0,9,0,0,2,0,3,0,0,0,0,0,0,2,2,1,0,1,0,0,0,0,0
19,0,4,0,2,1,0,2,0,0,0,4,0,0,0,9,0,0,0,1,0,2,0,0,0,2,0,0,1,0,2,0,1,0,0,0,0
16,1,0,0,0,1,0,0,0,0,2,0,4,0,9,0,0,0,0,2,0,4,1,0,0,0,0,0,2,1,0,0,0,0,0,0,0
17,4,0,2,1,0,0,0,0,0,4,0,2,0,9,0,0,0,0,4,2,0,0,1,0,0,0,1,0,2,0,0,1,0,0,0,0
20,3,0,0,2,0,0,4,0,0,0,1,0,0,0,0,9,0,2,0,1,0,2,0,0,1,0,2,0,1,0,0,0,0,3,0,0
16,0,0,0,0,0,0,1,0,2,0,0,0,0,2,0,9,0,4,2,0,1,0,2,0,0,1,0,2,0,0,0,1,0,0,1,0
17,0,2,1,0,0,0,0,0,0,4,2,0,9,0,2,0,0,0,2,0,0,0,1,0,0,1,0,1,0,2,0,0,3,0,0,0
18,0,0,2,1,0,0,1,0,0,0,2,4,0,4,9,0,0,0,0,0,3,0,0,0,0,0,2,0,0,0,1,0,0,0,1,0
16,0,0,3,0,0,4,3,0,0,0,4,0,0,4,9,0,0,0,0,0,1,0,0,0,0,0,0,2,1,0,3,0,0,0,0,0
20,2,0,3,0,0,2,0,0,0,0,0,0,0,9,0,4,0,0,1,0,2,0,1,0,0,2,0,0,2,0,0,0,1,0,0,0
17,2,0,3,0,0,4,0,3,0,0,4,0,0,9,0,2,0,0,2,1,0,0,0,0,0,0,2,3,0,0,0,0,0,1,0,0
18,0,0,2,1,0,0,1,0,0,0,0,0,4,2,0,9,0,4,0,0,1,0,2,0,0,1,0,2,0,0,1,0,0,0,1,0
20,0,2,0,0,4,0,0,0,1,0,0,0,9,0,2,0,0,0,4,0,0,1,0,2,0,1,0,2,0,0,0,1,0,0,1,0
19,0,3,0,0,0,2,0,0,2,4,2,0,9,0,0,0,0,0,0,0,2,0,1,0,0,0,0,1,0,2,0,1,0,0,0,0
19,4,0,0,2,1,0,0,2,0,0,4,0,0,0,9,0,0,2,3,0,0,0,0,0,0,0,2,0,1,0,0,0,0,0,1,0
18,0,0,3,0,0,0,0,0,0,2,1,0,2,9,0,0,0,2,0,2,3,0,0,0,2,0,0,2,1,0,0,1,0,0,0,0
19,0,2,0,0,0,2,0,0,0,1,0,0,0,0,9,0,4,0,3,0,0,2,0,0,0,0,2,0,0,2,0,0,0,1,0,0
20,0,0,1,0,1,0,3,0,0,2,2,0,9,0,2,0,0,0,2,0,0,1,0,4,0,3,0,0,0,0,1,0,0,0,0,0
20,0,4,0,0,0,4,4,0,0,0,4,0,0,0,9,0,0,0,0,1,0,0,0,0,0,0,2,2,1,0,1,0,0,0,1,0
19,0,2,0,0,1,0,0,0,1,0,2,0,9,0,2,0,0,0,1,0,0,1,0,4,2,1,0,2,0,0,0,0,0,0,0,0
19,1,0,0,0,0,2,0,3,0,0,4,0,2,9,0,0,0,0,0,4,2,0,0,2,0,0,0,1,0,0,0,0,0,3,0,0
20,2,2,0,0,1,0,0,0,3,0,0,4,9,0,4,0,0,0,0,0,0,1,0,0,0,0,0,2,1,0,3,0,0,0,0,0
19,1,0,0,0,4,2,0,2,1,0,0,0,0,0,9,0,0,0,0,0,2,0,1,0,1,0,0,2,0,0,3,0,0,0,0,0
18,0,4,0,1,0,0,0,0,0,0,4,2,0,0,9,0,0,0,1,0,2,0,0,0,0,0,0,1,0,2,3,0,0,0,0,0
18,0,0,1,0,1,0,0,0,4,1,0,2,9,0,0,2,0,0,2,0,0,0,1,0,0,1,0,0,2,0,0,3,0,0,0,0
19,0,2,1,0,4,0,0,0,1,0,0,0,9,0,2,0,0,4,4,0,0,1,0,0,0,1,0,2,0,0,0,0,0,0,1,0
22,0,1,0,0,4,0,2,4,0,0,0,0,0,0,9,0,0,0,4,0,2,1,0,2,0,0,0,2,0,0,0,1,0,0,1,0
20,2,0,1,0,1,0,0,0,0,4,2,0,9,0,2,0,0,0,0,0,0,0,1,0,0,0,3,0,0,2,0,0,0,1,0,0
18,1,0,3,0,0,2,2,2,3,0,0,0,0,0,9,0,2,0,1,0,2,0,0,0,0,0,0,3,0,0,3,0,0,0,0,0
19,1,0,2,0,0,0,0,2,0,3,0,0,2,0,9,0,2,4,0,1,0,0,0,0,0,0,2,1,0,0,0,0,0,3,0,0
21,0,0,4,0,1,0,0,0,0,1,0,0,9,0,0,0,2,0,0,3,0,0,0,4,2,0,0,0,0,0,0,1,0,1,0,0
18,0,1,0,2,0,4,2,0,0,0,0,0,0,0,4,9,0,0,0,2,0,1,0,0,0,0,0,2,1,0,1,0,0,0,0,0
18,0,0,1,0,1,0,2,0,0,2,4,0,0,9,0,0,0,2,0,2,1,0,0,0,0,0,2,3,0,0,1,0,0,0,0,0
18,0,2,0,0,0,0,0,0,0,2,1,0,0,9,0,0,2,0,2,3,0,0,0,4,0,0,2,1,0,0,0,0,0,0,0,0
18,2,0,1,0,0,0,0,0,2,0,4,0,9,0,0,2,0,0,3,0,0,0,0,2,0,2,3,0,0,0,0,0,0,0,0,0